{
  "colors": {
    "0": null,
    "1": "#7ec8a0",
    "2": "#f4a261",
    "3": "#a8dadc",
    "4": "#e76f51"
  },
  "labels": {
    "1": "北海道",
    "2": "本州",
    "3": "四国",
    "4": "九州"
  },
  "grid": [
    [0,0,0,0,0,0,0,0,0,0,0,0,0,0,0,0],
    [0,0,0,1,1,1,1,0,0,0,0,0,0,0,0,0],
    [0,0,1,1,1,1,1,1,0,0,0,0,0,0,0,0],
    [0,0,1,1,1,1,1,0,0,0,0,0,0,0,0,0],
    [0,0,0,0,0,2,0,0,0,0,0,0,0,0,0,0],
    [0,0,0,0,2,2,2,0,0,0,0,0,0,0,0,0],
    [0,0,0,2,2,2,2,2,0,0,0,0,0,0,0,0],
    [0,0,2,2,2,2,2,2,2,0,0,0,0,0,0,0],
    [0,0,0,2,2,2,2,2,2,2,0,0,0,0,0,0],
    [0,0,0,0,2,2,2,2,2,2,2,0,0,0,0,0],
    [0,0,0,0,0,2,2,2,2,2,2,2,0,0,0,0],
    [0,0,0,0,0,3,3,2,2,2,2,2,2,0,0,0],
    [0,0,0,0,4,4,3,0,0,0,2,2,0,0,0,0],
    [0,0,0,0,4,4,0,0,0,0,0,0,0,0,0,0],
    [0,0,0,0,0,0,0,0,0,0,0,0,0,0,0,0],
    [0,0,0,0,0,0,0,0,0,0,0,0,0,0,0,0]
  ]
}
